0000000000
0000000000
0P11121100
0001111100
0001111100
00C11C1100
000C009000
0000000000
0000000000
0000000000
