0000000000
0000000000
0P11111100
0001111100
0001111100
00C1111100
000C009000
0000000000
0000000000
0000000000
