0000000000
02P111R140
0100110000
01C1140000
0100610000
0100011000
061R181100
0000001000
0000009000
0000000000