0000000000
00000C0000
0011111100
00CP1211C0
0001111100
00011C1100
0000009000
0000000000
0000000000
0000000000
