0000000000
0011100000
0000100000
0000100000
0111110000
0000011000
0000001000
0000001000
0000004000
0000000000