0000000000
0611121440
0100110000
0611180000
0100610000
0100011000
0811140000
0000001000
0000009000
0000000000