1111111100
1111211110
0000100000
0000100000
0111620000
0000011000
0000001000
0000001000
0000009000
0000000000