0000000000
0611121110
0000110000
0000110000
0100680000
0800011000
0811140000
0000001000
0000009000
0000000000