0000000000
02P11R2400
0100001000
0111144000
0R00110000
0100011000
061R18R1C0
0000001000
0000009000
0000000000