0000000000
0000000000
0000000000
0021P20000
0920010000
0010010000
0041R40000
0000000000
0000000000
0000000000