-----------
-----------
-----------
---21P2----
--92--1----
---1--1----
---41R4----
-----------
-----------
-----------