0000000000
0000000000
000P61W000
0000100000
0000R00000
0000619000
0000000000
0000000000
0000000000
0000000000
