-----------
-----------
---1141----
---R119----
----P1-----
----11-----
----88-----
-----------
-----------
-----------
