0000000000
0000000000
0011410000
00R1190000
0000P10000
0000110000
0000880000
0000000000
0000000000
0000000000
