-----------
-----------
---P61W----
----1------
----R------
----619----
-----------
-----------
-----------
-----------
-----------
-----------
